111111111111111
100C00000000001
1000000000E0001
10000C000000001
100P00000000001
100000001110001
100000000010001
100000000010001
111111111111111