1111111111
1000C00001
1000000001
1C0000E001
1000000001
100P000C01
1000000001
1111111111