1111111111111
10010000000C1
100100E0000C1
10010010000C1
100100100E0C1
10010000000C1
1000011111001
1P00110000001
1111111111111