1111111111111
100100E100001
1001000000011
1001C01000011
1001001000011
100100P000011
1000011111001
1100110000001
1111111111111