1111111111111
10010000C0011
10010E0000011
1001001000011
1001001000011
100100P000011
1000011111001
1100110000001
1111111111111